. . . . . . . . # @
. # # # # # # . # .
. # . . . . # . # .
. # . # # . # . # .
. # . # _ . # . # .
. # . # # # # . # .
. # . . . . . . # .
. # # # # # # # # .
. # # # # # # # # .
. . . . . . . . . .
