. . . # # # . . . .
. . # # . # . # # #
. # # . . # # # . _
# # . . . . . . . .
# . . # . # . # . .
# # # # # # # # . .
. . # . @ # . . . .
. # # . # # . # . #
. # . . . . . . # #
. # . . . . . # # .
