. . . . . . . . @ #
# # # # . # # # # #
# # # # . # # # # #
# # # # . # # . . #
# # # # . # # # . #
# # # # . . . # @ #
# . # # # . . # # #
# # # # # # . . . #
# # . . . # # # _ #
# # # # # # # # # #
